Month,starting_balance,repayment,interest_paid,principal_paid,mortgage_name,interest_rate
1,400000.0,1686.42,1000.0,686.42,30 Year,0.03
2,399313.58,1686.42,998.28,688.14,30 Year,0.03
3,398625.44,1686.42,996.56,689.86,30 Year,0.03
4,397935.58,1686.42,994.83,691.59,30 Year,0.03
5,397243.99,1686.42,993.1,693.32,30 Year,0.03
6,396550.67,1686.42,991.37,695.05,30 Year,0.03
7,395855.62,1686.42,989.63,696.79,30 Year,0.03
8,395158.83,1686.42,987.89,698.53,30 Year,0.03
9,394460.3,1686.42,986.15,700.27,30 Year,0.03
10,393760.03,1686.42,984.4,702.02,30 Year,0.03
11,393058.01,1686.42,982.64,703.78,30 Year,0.03
12,392354.23,1686.42,980.88,705.54,30 Year,0.03
13,391648.69,1686.42,979.12,707.3,30 Year,0.03
14,390941.39,1686.42,977.35,709.07,30 Year,0.03
15,390232.32,1686.42,975.58,710.84,30 Year,0.03
16,389521.48,1686.42,973.8,712.62,30 Year,0.03
17,388808.86,1686.42,972.02,714.4,30 Year,0.03
18,388094.46,1686.42,970.23,716.19,30 Year,0.03
19,387378.27,1686.42,968.44,717.98,30 Year,0.03
20,386660.29,1686.42,966.65,719.77,30 Year,0.03
21,385940.52,1686.42,964.85,721.57,30 Year,0.03
22,385218.95,1686.42,963.04,723.38,30 Year,0.03
23,384495.57,1686.42,961.23,725.19,30 Year,0.03
24,383770.38,1686.42,959.42,727.0,30 Year,0.03
25,383043.38,1686.42,957.6,728.82,30 Year,0.03
26,382314.56,1686.42,955.78,730.64,30 Year,0.03
27,381583.92,1686.42,953.95,732.47,30 Year,0.03
28,380851.45,1686.42,952.12,734.3,30 Year,0.03
29,380117.15,1686.42,950.29,736.13,30 Year,0.03
30,379381.02,1686.42,948.45,737.97,30 Year,0.03
31,378643.05,1686.42,946.6,739.82,30 Year,0.03
32,377903.23,1686.42,944.75,741.67,30 Year,0.03
33,377161.56,1686.42,942.9,743.52,30 Year,0.03
34,376418.04,1686.42,941.04,745.38,30 Year,0.03
35,375672.66,1686.42,939.18,747.24,30 Year,0.03
36,374925.42,1686.42,937.31,749.11,30 Year,0.03
37,374176.31,1686.42,935.44,750.98,30 Year,0.03
38,373425.33,1686.42,933.56,752.86,30 Year,0.03
39,372672.47,1686.42,931.68,754.74,30 Year,0.03
40,371917.73,1686.42,929.79,756.63,30 Year,0.03
41,371161.1,1686.42,927.9,758.52,30 Year,0.03
42,370402.58,1686.42,926.0,760.42,30 Year,0.03
43,369642.16,1686.42,924.1,762.32,30 Year,0.03
44,368879.84,1686.42,922.19,764.23,30 Year,0.03
45,368115.61,1686.42,920.28,766.14,30 Year,0.03
46,367349.47,1686.42,918.37,768.05,30 Year,0.03
47,366581.42,1686.42,916.45,769.97,30 Year,0.03
48,365811.45,1686.42,914.52,771.9,30 Year,0.03
49,365039.55,1686.42,912.59,773.83,30 Year,0.03
50,364265.72,1686.42,910.66,775.76,30 Year,0.03
51,363489.96,1686.42,908.72,777.7,30 Year,0.03
52,362712.26,1686.42,906.78,779.64,30 Year,0.03
53,361932.62,1686.42,904.83,781.59,30 Year,0.03
54,361151.03,1686.42,902.87,783.55,30 Year,0.03
55,360367.48,1686.42,900.91,785.51,30 Year,0.03
56,359581.97,1686.42,898.95,787.47,30 Year,0.03
57,358794.5,1686.42,896.98,789.44,30 Year,0.03
58,358005.06,1686.42,895.01,791.41,30 Year,0.03
59,357213.65,1686.42,893.03,793.39,30 Year,0.03
60,356420.26,1686.42,891.05,795.37,30 Year,0.03
61,355624.89,1686.42,889.06,797.36,30 Year,0.03
62,354827.53,1686.42,887.06,799.36,30 Year,0.03
63,354028.17,1686.42,885.07,801.35,30 Year,0.03
64,353226.82,1686.42,883.06,803.36,30 Year,0.03
65,352423.46,1686.42,881.05,805.37,30 Year,0.03
66,351618.09,1686.42,879.04,807.38,30 Year,0.03
67,350810.71,1686.42,877.02,809.4,30 Year,0.03
68,350001.31,1686.42,875.0,811.42,30 Year,0.03
69,349189.89,1686.42,872.97,813.45,30 Year,0.03
70,348376.44,1686.42,870.94,815.48,30 Year,0.03
71,347560.96,1686.42,868.9,817.52,30 Year,0.03
72,346743.44,1686.42,866.85,819.57,30 Year,0.03
73,345923.87,1686.42,864.8,821.62,30 Year,0.03
74,345102.25,1686.42,862.75,823.67,30 Year,0.03
75,344278.58,1686.42,860.69,825.73,30 Year,0.03
76,343452.85,1686.42,858.63,827.79,30 Year,0.03
77,342625.06,1686.42,856.56,829.86,30 Year,0.03
78,341795.2,1686.42,854.48,831.94,30 Year,0.03
79,340963.26,1686.42,852.4,834.02,30 Year,0.03
80,340129.24,1686.42,850.32,836.1,30 Year,0.03
81,339293.14,1686.42,848.23,838.19,30 Year,0.03
82,338454.95,1686.42,846.13,840.29,30 Year,0.03
83,337614.66,1686.42,844.03,842.39,30 Year,0.03
84,336772.27,1686.42,841.93,844.49,30 Year,0.03
85,335927.78,1686.42,839.81,846.61,30 Year,0.03
86,335081.17,1686.42,837.7,848.72,30 Year,0.03
87,334232.45,1686.42,835.58,850.84,30 Year,0.03
88,333381.61,1686.42,833.45,852.97,30 Year,0.03
89,332528.64,1686.42,831.32,855.1,30 Year,0.03
90,331673.54,1686.42,829.18,857.24,30 Year,0.03
91,330816.3,1686.42,827.04,859.38,30 Year,0.03
92,329956.92,1686.42,824.89,861.53,30 Year,0.03
93,329095.39,1686.42,822.73,863.69,30 Year,0.03
94,328231.7,1686.42,820.57,865.85,30 Year,0.03
95,327365.85,1686.42,818.41,868.01,30 Year,0.03
96,326497.84,1686.42,816.24,870.18,30 Year,0.03
97,325627.66,1686.42,814.06,872.36,30 Year,0.03
98,324755.3,1686.42,811.88,874.54,30 Year,0.03
99,323880.76,1686.42,809.7,876.72,30 Year,0.03
100,323004.04,1686.42,807.51,878.91,30 Year,0.03
101,322125.13,1686.42,805.31,881.11,30 Year,0.03
102,321244.02,1686.42,803.11,883.31,30 Year,0.03
103,320360.71,1686.42,800.9,885.52,30 Year,0.03
104,319475.19,1686.42,798.68,887.74,30 Year,0.03
105,318587.45,1686.42,796.46,889.96,30 Year,0.03
106,317697.49,1686.42,794.24,892.18,30 Year,0.03
107,316805.31,1686.42,792.01,894.41,30 Year,0.03
108,315910.9,1686.42,789.77,896.65,30 Year,0.03
109,315014.25,1686.42,787.53,898.89,30 Year,0.03
110,314115.36,1686.42,785.28,901.14,30 Year,0.03
111,313214.22,1686.42,783.03,903.39,30 Year,0.03
112,312310.83,1686.42,780.77,905.65,30 Year,0.03
113,311405.18,1686.42,778.51,907.91,30 Year,0.03
114,310497.27,1686.42,776.24,910.18,30 Year,0.03
115,309587.09,1686.42,773.96,912.46,30 Year,0.03
116,308674.63,1686.42,771.68,914.74,30 Year,0.03
117,307759.89,1686.42,769.39,917.03,30 Year,0.03
118,306842.86,1686.42,767.1,919.32,30 Year,0.03
119,305923.54,1686.42,764.8,921.62,30 Year,0.03
120,305001.92,1686.42,762.5,923.92,30 Year,0.03
121,304078.0,1686.42,760.19,926.23,30 Year,0.03
122,303151.77,1686.42,757.87,928.55,30 Year,0.03
123,302223.22,1686.42,755.55,930.87,30 Year,0.03
124,301292.35,1686.42,753.23,933.19,30 Year,0.03
125,300359.16,1686.42,750.89,935.53,30 Year,0.03
126,299423.63,1686.42,748.55,937.87,30 Year,0.03
127,298485.76,1686.42,746.21,940.21,30 Year,0.03
128,297545.55,1686.42,743.86,942.56,30 Year,0.03
129,296602.99,1686.42,741.5,944.92,30 Year,0.03
130,295658.07,1686.42,739.14,947.28,30 Year,0.03
131,294710.79,1686.42,736.77,949.65,30 Year,0.03
132,293761.14,1686.42,734.4,952.02,30 Year,0.03
133,292809.12,1686.42,732.02,954.4,30 Year,0.03
134,291854.72,1686.42,729.63,956.79,30 Year,0.03
135,290897.93,1686.42,727.24,959.18,30 Year,0.03
136,289938.75,1686.42,724.84,961.58,30 Year,0.03
137,288977.17,1686.42,722.44,963.98,30 Year,0.03
138,288013.19,1686.42,720.03,966.39,30 Year,0.03
139,287046.8,1686.42,717.61,968.81,30 Year,0.03
140,286077.99,1686.42,715.19,971.23,30 Year,0.03
141,285106.76,1686.42,712.76,973.66,30 Year,0.03
142,284133.1,1686.42,710.33,976.09,30 Year,0.03
143,283157.01,1686.42,707.89,978.53,30 Year,0.03
144,282178.48,1686.42,705.44,980.98,30 Year,0.03
145,281197.5,1686.42,702.99,983.43,30 Year,0.03
146,280214.07,1686.42,700.53,985.89,30 Year,0.03
147,279228.18,1686.42,698.07,988.35,30 Year,0.03
148,278239.83,1686.42,695.59,990.83,30 Year,0.03
149,277249.0,1686.42,693.12,993.3,30 Year,0.03
150,276255.7,1686.42,690.63,995.79,30 Year,0.03
151,275259.91,1686.42,688.14,998.28,30 Year,0.03
152,274261.63,1686.42,685.65,1000.77,30 Year,0.03
153,273260.86,1686.42,683.15,1003.27,30 Year,0.03
154,272257.59,1686.42,680.64,1005.78,30 Year,0.03
155,271251.81,1686.42,678.12,1008.3,30 Year,0.03
156,270243.51,1686.42,675.6,1010.82,30 Year,0.03
157,269232.69,1686.42,673.08,1013.34,30 Year,0.03
158,268219.35,1686.42,670.54,1015.88,30 Year,0.03
159,267203.47,1686.42,668.0,1018.42,30 Year,0.03
160,266185.05,1686.42,665.46,1020.96,30 Year,0.03
161,265164.09,1686.42,662.91,1023.51,30 Year,0.03
162,264140.58,1686.42,660.35,1026.07,30 Year,0.03
163,263114.51,1686.42,657.78,1028.64,30 Year,0.03
164,262085.87,1686.42,655.21,1031.21,30 Year,0.03
165,261054.66,1686.42,652.63,1033.79,30 Year,0.03
166,260020.87,1686.42,650.05,1036.37,30 Year,0.03
167,258984.5,1686.42,647.46,1038.96,30 Year,0.03
168,257945.54,1686.42,644.86,1041.56,30 Year,0.03
169,256903.98,1686.42,642.25,1044.17,30 Year,0.03
170,255859.81,1686.42,639.64,1046.78,30 Year,0.03
171,254813.03,1686.42,637.03,1049.39,30 Year,0.03
172,253763.64,1686.42,634.4,1052.02,30 Year,0.03
173,252711.62,1686.42,631.77,1054.65,30 Year,0.03
174,251656.97,1686.42,629.14,1057.28,30 Year,0.03
175,250599.69,1686.42,626.49,1059.93,30 Year,0.03
176,249539.76,1686.42,623.84,1062.58,30 Year,0.03
177,248477.18,1686.42,621.19,1065.23,30 Year,0.03
178,247411.95,1686.42,618.52,1067.9,30 Year,0.03
179,246344.05,1686.42,615.86,1070.56,30 Year,0.03
180,245273.49,1686.42,613.18,1073.24,30 Year,0.03
181,244200.25,1686.42,610.5,1075.92,30 Year,0.03
182,243124.33,1686.42,607.81,1078.61,30 Year,0.03
183,242045.72,1686.42,605.11,1081.31,30 Year,0.03
184,240964.41,1686.42,602.41,1084.01,30 Year,0.03
185,239880.4,1686.42,599.7,1086.72,30 Year,0.03
186,238793.68,1686.42,596.98,1089.44,30 Year,0.03
187,237704.24,1686.42,594.26,1092.16,30 Year,0.03
188,236612.08,1686.42,591.53,1094.89,30 Year,0.03
189,235517.19,1686.42,588.79,1097.63,30 Year,0.03
190,234419.56,1686.42,586.04,1100.38,30 Year,0.03
191,233319.18,1686.42,583.29,1103.13,30 Year,0.03
192,232216.05,1686.42,580.54,1105.88,30 Year,0.03
193,231110.17,1686.42,577.77,1108.65,30 Year,0.03
194,230001.52,1686.42,575.0,1111.42,30 Year,0.03
195,228890.1,1686.42,572.22,1114.2,30 Year,0.03
196,227775.9,1686.42,569.43,1116.99,30 Year,0.03
197,226658.91,1686.42,566.64,1119.78,30 Year,0.03
198,225539.13,1686.42,563.84,1122.58,30 Year,0.03
199,224416.55,1686.42,561.04,1125.38,30 Year,0.03
200,223291.17,1686.42,558.22,1128.2,30 Year,0.03
201,222162.97,1686.42,555.4,1131.02,30 Year,0.03
202,221031.95,1686.42,552.57,1133.85,30 Year,0.03
203,219898.1,1686.42,549.74,1136.68,30 Year,0.03
204,218761.42,1686.42,546.9,1139.52,30 Year,0.03
205,217621.9,1686.42,544.05,1142.37,30 Year,0.03
206,216479.53,1686.42,541.19,1145.23,30 Year,0.03
207,215334.3,1686.42,538.33,1148.09,30 Year,0.03
208,214186.21,1686.42,535.46,1150.96,30 Year,0.03
209,213035.25,1686.42,532.58,1153.84,30 Year,0.03
210,211881.41,1686.42,529.7,1156.72,30 Year,0.03
211,210724.69,1686.42,526.81,1159.61,30 Year,0.03
212,209565.08,1686.42,523.91,1162.51,30 Year,0.03
213,208402.57,1686.42,521.0,1165.42,30 Year,0.03
214,207237.15,1686.42,518.09,1168.33,30 Year,0.03
215,206068.82,1686.42,515.17,1171.25,30 Year,0.03
216,204897.57,1686.42,512.24,1174.18,30 Year,0.03
217,203723.39,1686.42,509.3,1177.12,30 Year,0.03
218,202546.27,1686.42,506.36,1180.06,30 Year,0.03
219,201366.21,1686.42,503.41,1183.01,30 Year,0.03
220,200183.2,1686.42,500.45,1185.97,30 Year,0.03
221,198997.23,1686.42,497.49,1188.93,30 Year,0.03
222,197808.3,1686.42,494.52,1191.9,30 Year,0.03
223,196616.4,1686.42,491.54,1194.88,30 Year,0.03
224,195421.52,1686.42,488.55,1197.87,30 Year,0.03
225,194223.65,1686.42,485.55,1200.87,30 Year,0.03
226,193022.78,1686.42,482.55,1203.87,30 Year,0.03
227,191818.91,1686.42,479.54,1206.88,30 Year,0.03
228,190612.03,1686.42,476.53,1209.89,30 Year,0.03
229,189402.14,1686.42,473.5,1212.92,30 Year,0.03
230,188189.22,1686.42,470.47,1215.95,30 Year,0.03
231,186973.27,1686.42,467.43,1218.99,30 Year,0.03
232,185754.28,1686.42,464.38,1222.04,30 Year,0.03
233,184532.24,1686.42,461.33,1225.09,30 Year,0.03
234,183307.15,1686.42,458.26,1228.16,30 Year,0.03
235,182078.99,1686.42,455.19,1231.23,30 Year,0.03
236,180847.76,1686.42,452.11,1234.31,30 Year,0.03
237,179613.45,1686.42,449.03,1237.39,30 Year,0.03
238,178376.06,1686.42,445.94,1240.48,30 Year,0.03
239,177135.58,1686.42,442.83,1243.59,30 Year,0.03
240,175891.99,1686.42,439.72,1246.7,30 Year,0.03
241,174645.29,1686.42,436.61,1249.81,30 Year,0.03
242,173395.48,1686.42,433.48,1252.94,30 Year,0.03
243,172142.54,1686.42,430.35,1256.07,30 Year,0.03
244,170886.47,1686.42,427.21,1259.21,30 Year,0.03
245,169627.26,1686.42,424.06,1262.36,30 Year,0.03
246,168364.9,1686.42,420.91,1265.51,30 Year,0.03
247,167099.39,1686.42,417.74,1268.68,30 Year,0.03
248,165830.71,1686.42,414.57,1271.85,30 Year,0.03
249,164558.86,1686.42,411.39,1275.03,30 Year,0.03
250,163283.83,1686.42,408.2,1278.22,30 Year,0.03
251,162005.61,1686.42,405.01,1281.41,30 Year,0.03
252,160724.2,1686.42,401.81,1284.61,30 Year,0.03
253,159439.59,1686.42,398.59,1287.83,30 Year,0.03
254,158151.76,1686.42,395.37,1291.05,30 Year,0.03
255,156860.71,1686.42,392.15,1294.27,30 Year,0.03
256,155566.44,1686.42,388.91,1297.51,30 Year,0.03
257,154268.93,1686.42,385.67,1300.75,30 Year,0.03
258,152968.18,1686.42,382.42,1304.0,30 Year,0.03
259,151664.18,1686.42,379.16,1307.26,30 Year,0.03
260,150356.92,1686.42,375.89,1310.53,30 Year,0.03
261,149046.39,1686.42,372.61,1313.81,30 Year,0.03
262,147732.58,1686.42,369.33,1317.09,30 Year,0.03
263,146415.49,1686.42,366.03,1320.39,30 Year,0.03
264,145095.1,1686.42,362.73,1323.69,30 Year,0.03
265,143771.41,1686.42,359.42,1327.0,30 Year,0.03
266,142444.41,1686.42,356.11,1330.31,30 Year,0.03
267,141114.1,1686.42,352.78,1333.64,30 Year,0.03
268,139780.46,1686.42,349.45,1336.97,30 Year,0.03
269,138443.49,1686.42,346.1,1340.32,30 Year,0.03
270,137103.17,1686.42,342.75,1343.67,30 Year,0.03
271,135759.5,1686.42,339.39,1347.03,30 Year,0.03
272,134412.47,1686.42,336.03,1350.39,30 Year,0.03
273,133062.08,1686.42,332.65,1353.77,30 Year,0.03
274,131708.31,1686.42,329.27,1357.15,30 Year,0.03
275,130351.16,1686.42,325.87,1360.55,30 Year,0.03
276,128990.61,1686.42,322.47,1363.95,30 Year,0.03
277,127626.66,1686.42,319.06,1367.36,30 Year,0.03
278,126259.3,1686.42,315.64,1370.78,30 Year,0.03
279,124888.52,1686.42,312.22,1374.2,30 Year,0.03
280,123514.32,1686.42,308.78,1377.64,30 Year,0.03
281,122136.68,1686.42,305.34,1381.08,30 Year,0.03
282,120755.6,1686.42,301.88,1384.54,30 Year,0.03
283,119371.06,1686.42,298.42,1388.0,30 Year,0.03
284,117983.06,1686.42,294.95,1391.47,30 Year,0.03
285,116591.59,1686.42,291.47,1394.95,30 Year,0.03
286,115196.64,1686.42,287.99,1398.43,30 Year,0.03
287,113798.21,1686.42,284.49,1401.93,30 Year,0.03
288,112396.28,1686.42,280.99,1405.43,30 Year,0.03
289,110990.85,1686.42,277.47,1408.95,30 Year,0.03
290,109581.9,1686.42,273.95,1412.47,30 Year,0.03
291,108169.43,1686.42,270.42,1416.0,30 Year,0.03
292,106753.43,1686.42,266.88,1419.54,30 Year,0.03
293,105333.89,1686.42,263.33,1423.09,30 Year,0.03
294,103910.8,1686.42,259.77,1426.65,30 Year,0.03
295,102484.15,1686.42,256.21,1430.21,30 Year,0.03
296,101053.94,1686.42,252.63,1433.79,30 Year,0.03
297,99620.15,1686.42,249.05,1437.37,30 Year,0.03
298,98182.78,1686.42,245.45,1440.97,30 Year,0.03
299,96741.81,1686.42,241.85,1444.57,30 Year,0.03
300,95297.24,1686.42,238.24,1448.18,30 Year,0.03
301,93849.06,1686.42,234.62,1451.8,30 Year,0.03
302,92397.26,1686.42,230.99,1455.43,30 Year,0.03
303,90941.83,1686.42,227.35,1459.07,30 Year,0.03
304,89482.76,1686.42,223.7,1462.72,30 Year,0.03
305,88020.04,1686.42,220.05,1466.37,30 Year,0.03
306,86553.67,1686.42,216.38,1470.04,30 Year,0.03
307,85083.63,1686.42,212.7,1473.72,30 Year,0.03
308,83609.91,1686.42,209.02,1477.4,30 Year,0.03
309,82132.51,1686.42,205.33,1481.09,30 Year,0.03
310,80651.42,1686.42,201.62,1484.8,30 Year,0.03
311,79166.62,1686.42,197.91,1488.51,30 Year,0.03
312,77678.11,1686.42,194.19,1492.23,30 Year,0.03
313,76185.88,1686.42,190.46,1495.96,30 Year,0.03
314,74689.92,1686.42,186.72,1499.7,30 Year,0.03
315,73190.22,1686.42,182.97,1503.45,30 Year,0.03
316,71686.77,1686.42,179.21,1507.21,30 Year,0.03
317,70179.56,1686.42,175.44,1510.98,30 Year,0.03
318,68668.58,1686.42,171.67,1514.75,30 Year,0.03
319,67153.83,1686.42,167.88,1518.54,30 Year,0.03
320,65635.29,1686.42,164.08,1522.34,30 Year,0.03
321,64112.95,1686.42,160.28,1526.14,30 Year,0.03
322,62586.81,1686.42,156.46,1529.96,30 Year,0.03
323,61056.85,1686.42,152.64,1533.78,30 Year,0.03
324,59523.07,1686.42,148.8,1537.62,30 Year,0.03
325,57985.45,1686.42,144.96,1541.46,30 Year,0.03
326,56443.99,1686.42,141.1,1545.32,30 Year,0.03
327,54898.67,1686.42,137.24,1549.18,30 Year,0.03
328,53349.49,1686.42,133.37,1553.05,30 Year,0.03
329,51796.44,1686.42,129.49,1556.93,30 Year,0.03
330,50239.51,1686.42,125.59,1560.83,30 Year,0.03
331,48678.68,1686.42,121.69,1564.73,30 Year,0.03
332,47113.95,1686.42,117.78,1568.64,30 Year,0.03
333,45545.31,1686.42,113.86,1572.56,30 Year,0.03
334,43972.75,1686.42,109.93,1576.49,30 Year,0.03
335,42396.26,1686.42,105.99,1580.43,30 Year,0.03
336,40815.83,1686.42,102.03,1584.39,30 Year,0.03
337,39231.44,1686.42,98.07,1588.35,30 Year,0.03
338,37643.09,1686.42,94.1,1592.32,30 Year,0.03
339,36050.77,1686.42,90.12,1596.3,30 Year,0.03
340,34454.47,1686.42,86.13,1600.29,30 Year,0.03
341,32854.18,1686.42,82.13,1604.29,30 Year,0.03
342,31249.89,1686.42,78.12,1608.3,30 Year,0.03
343,29641.59,1686.42,74.1,1612.32,30 Year,0.03
344,28029.27,1686.42,70.07,1616.35,30 Year,0.03
345,26412.92,1686.42,66.03,1620.39,30 Year,0.03
346,24792.53,1686.42,61.98,1624.44,30 Year,0.03
347,23168.09,1686.42,57.92,1628.5,30 Year,0.03
348,21539.59,1686.42,53.84,1632.58,30 Year,0.03
349,19907.01,1686.42,49.76,1636.66,30 Year,0.03
350,18270.35,1686.42,45.67,1640.75,30 Year,0.03
351,16629.6,1686.42,41.57,1644.85,30 Year,0.03
352,14984.75,1686.42,37.46,1648.96,30 Year,0.03
353,13335.79,1686.42,33.33,1653.09,30 Year,0.03
354,11682.7,1686.42,29.2,1657.22,30 Year,0.03
355,10025.48,1686.42,25.06,1661.36,30 Year,0.03
356,8364.12,1686.42,20.91,1665.51,30 Year,0.03
357,6698.61,1686.42,16.74,1669.68,30 Year,0.03
358,5028.93,1686.42,12.57,1673.85,30 Year,0.03
359,3355.08,1686.42,8.38,1678.04,30 Year,0.03
360,1677.04,1686.42,4.19,1682.23,30 Year,0.03
1,400000.0,2147.29,1666.66,480.63,30 Year,0.05
2,399519.37,2147.29,1664.66,482.63,30 Year,0.05
3,399036.74,2147.29,1662.65,484.64,30 Year,0.05
4,398552.1,2147.29,1660.63,486.66,30 Year,0.05
5,398065.44,2147.29,1658.6,488.69,30 Year,0.05
6,397576.75,2147.29,1656.56,490.73,30 Year,0.05
7,397086.02,2147.29,1654.52,492.77,30 Year,0.05
8,396593.25,2147.29,1652.47,494.82,30 Year,0.05
9,396098.43,2147.29,1650.41,496.88,30 Year,0.05
10,395601.55,2147.29,1648.33,498.96,30 Year,0.05
11,395102.59,2147.29,1646.26,501.03,30 Year,0.05
12,394601.56,2147.29,1644.17,503.12,30 Year,0.05
13,394098.44,2147.29,1642.07,505.22,30 Year,0.05
14,393593.22,2147.29,1639.97,507.32,30 Year,0.05
15,393085.9,2147.29,1637.85,509.44,30 Year,0.05
16,392576.46,2147.29,1635.73,511.56,30 Year,0.05
17,392064.9,2147.29,1633.6,513.69,30 Year,0.05
18,391551.21,2147.29,1631.46,515.83,30 Year,0.05
19,391035.38,2147.29,1629.31,517.98,30 Year,0.05
20,390517.4,2147.29,1627.15,520.14,30 Year,0.05
21,389997.26,2147.29,1624.98,522.31,30 Year,0.05
22,389474.95,2147.29,1622.81,524.48,30 Year,0.05
23,388950.47,2147.29,1620.62,526.67,30 Year,0.05
24,388423.8,2147.29,1618.43,528.86,30 Year,0.05
25,387894.94,2147.29,1616.22,531.07,30 Year,0.05
26,387363.87,2147.29,1614.01,533.28,30 Year,0.05
27,386830.59,2147.29,1611.79,535.5,30 Year,0.05
28,386295.09,2147.29,1609.56,537.73,30 Year,0.05
29,385757.36,2147.29,1607.32,539.97,30 Year,0.05
30,385217.39,2147.29,1605.07,542.22,30 Year,0.05
31,384675.17,2147.29,1602.81,544.48,30 Year,0.05
32,384130.69,2147.29,1600.54,546.75,30 Year,0.05
33,383583.94,2147.29,1598.26,549.03,30 Year,0.05
34,383034.91,2147.29,1595.97,551.32,30 Year,0.05
35,382483.59,2147.29,1593.68,553.61,30 Year,0.05
36,381929.98,2147.29,1591.37,555.92,30 Year,0.05
37,381374.06,2147.29,1589.05,558.24,30 Year,0.05
38,380815.82,2147.29,1586.73,560.56,30 Year,0.05
39,380255.26,2147.29,1584.39,562.9,30 Year,0.05
40,379692.36,2147.29,1582.05,565.24,30 Year,0.05
41,379127.12,2147.29,1579.69,567.6,30 Year,0.05
42,378559.52,2147.29,1577.33,569.96,30 Year,0.05
43,377989.56,2147.29,1574.95,572.34,30 Year,0.05
44,377417.22,2147.29,1572.57,574.72,30 Year,0.05
45,376842.5,2147.29,1570.17,577.12,30 Year,0.05
46,376265.38,2147.29,1567.77,579.52,30 Year,0.05
47,375685.86,2147.29,1565.35,581.94,30 Year,0.05
48,375103.92,2147.29,1562.93,584.36,30 Year,0.05
49,374519.56,2147.29,1560.49,586.8,30 Year,0.05
50,373932.76,2147.29,1558.05,589.24,30 Year,0.05
51,373343.52,2147.29,1555.59,591.7,30 Year,0.05
52,372751.82,2147.29,1553.13,594.16,30 Year,0.05
53,372157.66,2147.29,1550.65,596.64,30 Year,0.05
54,371561.02,2147.29,1548.17,599.12,30 Year,0.05
55,370961.9,2147.29,1545.67,601.62,30 Year,0.05
56,370360.28,2147.29,1543.16,604.13,30 Year,0.05
57,369756.15,2147.29,1540.65,606.64,30 Year,0.05
58,369149.51,2147.29,1538.12,609.17,30 Year,0.05
59,368540.34,2147.29,1535.58,611.71,30 Year,0.05
60,367928.63,2147.29,1533.03,614.26,30 Year,0.05
61,367314.37,2147.29,1530.47,616.82,30 Year,0.05
62,366697.55,2147.29,1527.9,619.39,30 Year,0.05
63,366078.16,2147.29,1525.32,621.97,30 Year,0.05
64,365456.19,2147.29,1522.73,624.56,30 Year,0.05
65,364831.63,2147.29,1520.13,627.16,30 Year,0.05
66,364204.47,2147.29,1517.51,629.78,30 Year,0.05
67,363574.69,2147.29,1514.89,632.4,30 Year,0.05
68,362942.29,2147.29,1512.25,635.04,30 Year,0.05
69,362307.25,2147.29,1509.61,637.68,30 Year,0.05
70,361669.57,2147.29,1506.95,640.34,30 Year,0.05
71,361029.23,2147.29,1504.28,643.01,30 Year,0.05
72,360386.22,2147.29,1501.6,645.69,30 Year,0.05
73,359740.53,2147.29,1498.91,648.38,30 Year,0.05
74,359092.15,2147.29,1496.21,651.08,30 Year,0.05
75,358441.07,2147.29,1493.5,653.79,30 Year,0.05
76,357787.28,2147.29,1490.78,656.51,30 Year,0.05
77,357130.77,2147.29,1488.04,659.25,30 Year,0.05
78,356471.52,2147.29,1485.29,662.0,30 Year,0.05
79,355809.52,2147.29,1482.53,664.76,30 Year,0.05
80,355144.76,2147.29,1479.76,667.53,30 Year,0.05
81,354477.23,2147.29,1476.98,670.31,30 Year,0.05
82,353806.92,2147.29,1474.19,673.1,30 Year,0.05
83,353133.82,2147.29,1471.39,675.9,30 Year,0.05
84,352457.92,2147.29,1468.57,678.72,30 Year,0.05
85,351779.2,2147.29,1465.74,681.55,30 Year,0.05
86,351097.65,2147.29,1462.9,684.39,30 Year,0.05
87,350413.26,2147.29,1460.05,687.24,30 Year,0.05
88,349726.02,2147.29,1457.19,690.1,30 Year,0.05
89,349035.92,2147.29,1454.31,692.98,30 Year,0.05
90,348342.94,2147.29,1451.42,695.87,30 Year,0.05
91,347647.07,2147.29,1448.52,698.77,30 Year,0.05
92,346948.3,2147.29,1445.61,701.68,30 Year,0.05
93,346246.62,2147.29,1442.69,704.6,30 Year,0.05
94,345542.02,2147.29,1439.75,707.54,30 Year,0.05
95,344834.48,2147.29,1436.81,710.48,30 Year,0.05
96,344124.0,2147.29,1433.85,713.44,30 Year,0.05
97,343410.56,2147.29,1430.87,716.42,30 Year,0.05
98,342694.14,2147.29,1427.89,719.4,30 Year,0.05
99,341974.74,2147.29,1424.89,722.4,30 Year,0.05
100,341252.34,2147.29,1421.88,725.41,30 Year,0.05
101,340526.93,2147.29,1418.86,728.43,30 Year,0.05
102,339798.5,2147.29,1415.82,731.47,30 Year,0.05
103,339067.03,2147.29,1412.77,734.52,30 Year,0.05
104,338332.51,2147.29,1409.71,737.58,30 Year,0.05
105,337594.93,2147.29,1406.64,740.65,30 Year,0.05
106,336854.28,2147.29,1403.55,743.74,30 Year,0.05
107,336110.54,2147.29,1400.46,746.83,30 Year,0.05
108,335363.71,2147.29,1397.34,749.95,30 Year,0.05
109,334613.76,2147.29,1394.22,753.07,30 Year,0.05
110,333860.69,2147.29,1391.08,756.21,30 Year,0.05
111,333104.48,2147.29,1387.93,759.36,30 Year,0.05
112,332345.12,2147.29,1384.77,762.52,30 Year,0.05
113,331582.6,2147.29,1381.59,765.7,30 Year,0.05
114,330816.9,2147.29,1378.4,768.89,30 Year,0.05
115,330048.01,2147.29,1375.2,772.09,30 Year,0.05
116,329275.92,2147.29,1371.98,775.31,30 Year,0.05
117,328500.61,2147.29,1368.75,778.54,30 Year,0.05
118,327722.07,2147.29,1365.5,781.79,30 Year,0.05
119,326940.28,2147.29,1362.25,785.04,30 Year,0.05
120,326155.24,2147.29,1358.98,788.31,30 Year,0.05
121,325366.93,2147.29,1355.69,791.6,30 Year,0.05
122,324575.33,2147.29,1352.39,794.9,30 Year,0.05
123,323780.43,2147.29,1349.08,798.21,30 Year,0.05
124,322982.22,2147.29,1345.75,801.54,30 Year,0.05
125,322180.68,2147.29,1342.41,804.88,30 Year,0.05
126,321375.8,2147.29,1339.06,808.23,30 Year,0.05
127,320567.57,2147.29,1335.69,811.6,30 Year,0.05
128,319755.97,2147.29,1332.31,814.98,30 Year,0.05
129,318940.99,2147.29,1328.92,818.37,30 Year,0.05
130,318122.62,2147.29,1325.51,821.78,30 Year,0.05
131,317300.84,2147.29,1322.08,825.21,30 Year,0.05
132,316475.63,2147.29,1318.64,828.65,30 Year,0.05
133,315646.98,2147.29,1315.19,832.1,30 Year,0.05
134,314814.88,2147.29,1311.72,835.57,30 Year,0.05
135,313979.31,2147.29,1308.24,839.05,30 Year,0.05
136,313140.26,2147.29,1304.75,842.54,30 Year,0.05
137,312297.72,2147.29,1301.24,846.05,30 Year,0.05
138,311451.67,2147.29,1297.71,849.58,30 Year,0.05
139,310602.09,2147.29,1294.17,853.12,30 Year,0.05
140,309748.97,2147.29,1290.62,856.67,30 Year,0.05
141,308892.3,2147.29,1287.05,860.24,30 Year,0.05
142,308032.06,2147.29,1283.46,863.83,30 Year,0.05
143,307168.23,2147.29,1279.86,867.43,30 Year,0.05
144,306300.8,2147.29,1276.25,871.04,30 Year,0.05
145,305429.76,2147.29,1272.62,874.67,30 Year,0.05
146,304555.09,2147.29,1268.97,878.32,30 Year,0.05
147,303676.77,2147.29,1265.31,881.98,30 Year,0.05
148,302794.79,2147.29,1261.64,885.65,30 Year,0.05
149,301909.14,2147.29,1257.95,889.34,30 Year,0.05
150,301019.8,2147.29,1254.24,893.05,30 Year,0.05
151,300126.75,2147.29,1250.52,896.77,30 Year,0.05
152,299229.98,2147.29,1246.79,900.5,30 Year,0.05
153,298329.48,2147.29,1243.03,904.26,30 Year,0.05
154,297425.22,2147.29,1239.27,908.02,30 Year,0.05
155,296517.2,2147.29,1235.48,911.81,30 Year,0.05
156,295605.39,2147.29,1231.68,915.61,30 Year,0.05
157,294689.78,2147.29,1227.87,919.42,30 Year,0.05
158,293770.36,2147.29,1224.04,923.25,30 Year,0.05
159,292847.11,2147.29,1220.19,927.1,30 Year,0.05
160,291920.01,2147.29,1216.33,930.96,30 Year,0.05
161,290989.05,2147.29,1212.45,934.84,30 Year,0.05
162,290054.21,2147.29,1208.55,938.74,30 Year,0.05
163,289115.47,2147.29,1204.64,942.65,30 Year,0.05
164,288172.82,2147.29,1200.72,946.57,30 Year,0.05
165,287226.25,2147.29,1196.77,950.52,30 Year,0.05
166,286275.73,2147.29,1192.81,954.48,30 Year,0.05
167,285321.25,2147.29,1188.83,958.46,30 Year,0.05
168,284362.79,2147.29,1184.84,962.45,30 Year,0.05
169,283400.34,2147.29,1180.83,966.46,30 Year,0.05
170,282433.88,2147.29,1176.8,970.49,30 Year,0.05
171,281463.39,2147.29,1172.76,974.53,30 Year,0.05
172,280488.86,2147.29,1168.7,978.59,30 Year,0.05
173,279510.27,2147.29,1164.62,982.67,30 Year,0.05
174,278527.6,2147.29,1160.53,986.76,30 Year,0.05
175,277540.84,2147.29,1156.42,990.87,30 Year,0.05
176,276549.97,2147.29,1152.29,995.0,30 Year,0.05
177,275554.97,2147.29,1148.14,999.15,30 Year,0.05
178,274555.82,2147.29,1143.98,1003.31,30 Year,0.05
179,273552.51,2147.29,1139.8,1007.49,30 Year,0.05
180,272545.02,2147.29,1135.6,1011.69,30 Year,0.05
181,271533.33,2147.29,1131.38,1015.91,30 Year,0.05
182,270517.42,2147.29,1127.15,1020.14,30 Year,0.05
183,269497.28,2147.29,1122.9,1024.39,30 Year,0.05
184,268472.89,2147.29,1118.63,1028.66,30 Year,0.05
185,267444.23,2147.29,1114.35,1032.94,30 Year,0.05
186,266411.29,2147.29,1110.04,1037.25,30 Year,0.05
187,265374.04,2147.29,1105.72,1041.57,30 Year,0.05
188,264332.47,2147.29,1101.38,1045.91,30 Year,0.05
189,263286.56,2147.29,1097.02,1050.27,30 Year,0.05
190,262236.29,2147.29,1092.65,1054.64,30 Year,0.05
191,261181.65,2147.29,1088.25,1059.04,30 Year,0.05
192,260122.61,2147.29,1083.84,1063.45,30 Year,0.05
193,259059.16,2147.29,1079.41,1067.88,30 Year,0.05
194,257991.28,2147.29,1074.96,1072.33,30 Year,0.05
195,256918.95,2147.29,1070.49,1076.8,30 Year,0.05
196,255842.15,2147.29,1066.0,1081.29,30 Year,0.05
197,254760.86,2147.29,1061.5,1085.79,30 Year,0.05
198,253675.07,2147.29,1056.97,1090.32,30 Year,0.05
199,252584.75,2147.29,1052.43,1094.86,30 Year,0.05
200,251489.89,2147.29,1047.87,1099.42,30 Year,0.05
201,250390.47,2147.29,1043.29,1104.0,30 Year,0.05
202,249286.47,2147.29,1038.69,1108.6,30 Year,0.05
203,248177.87,2147.29,1034.07,1113.22,30 Year,0.05
204,247064.65,2147.29,1029.43,1117.86,30 Year,0.05
205,245946.79,2147.29,1024.77,1122.52,30 Year,0.05
206,244824.27,2147.29,1020.1,1127.19,30 Year,0.05
207,243697.08,2147.29,1015.4,1131.89,30 Year,0.05
208,242565.19,2147.29,1010.68,1136.61,30 Year,0.05
209,241428.58,2147.29,1005.95,1141.34,30 Year,0.05
210,240287.24,2147.29,1001.19,1146.1,30 Year,0.05
211,239141.14,2147.29,996.42,1150.87,30 Year,0.05
212,237990.27,2147.29,991.62,1155.67,30 Year,0.05
213,236834.6,2147.29,986.81,1160.48,30 Year,0.05
214,235674.12,2147.29,981.97,1165.32,30 Year,0.05
215,234508.8,2147.29,977.11,1170.18,30 Year,0.05
216,233338.62,2147.29,972.24,1175.05,30 Year,0.05
217,232163.57,2147.29,967.34,1179.95,30 Year,0.05
218,230983.62,2147.29,962.43,1184.86,30 Year,0.05
219,229798.76,2147.29,957.49,1189.8,30 Year,0.05
220,228608.96,2147.29,952.53,1194.76,30 Year,0.05
221,227414.2,2147.29,947.55,1199.74,30 Year,0.05
222,226214.46,2147.29,942.56,1204.73,30 Year,0.05
223,225009.73,2147.29,937.54,1209.75,30 Year,0.05
224,223799.98,2147.29,932.49,1214.8,30 Year,0.05
225,222585.18,2147.29,927.43,1219.86,30 Year,0.05
226,221365.32,2147.29,922.35,1224.94,30 Year,0.05
227,220140.38,2147.29,917.25,1230.04,30 Year,0.05
228,218910.34,2147.29,912.12,1235.17,30 Year,0.05
229,217675.17,2147.29,906.97,1240.32,30 Year,0.05
230,216434.85,2147.29,901.81,1245.48,30 Year,0.05
231,215189.37,2147.29,896.62,1250.67,30 Year,0.05
232,213938.7,2147.29,891.41,1255.88,30 Year,0.05
233,212682.82,2147.29,886.17,1261.12,30 Year,0.05
234,211421.7,2147.29,880.92,1266.37,30 Year,0.05
235,210155.33,2147.29,875.64,1271.65,30 Year,0.05
236,208883.68,2147.29,870.34,1276.95,30 Year,0.05
237,207606.73,2147.29,865.02,1282.27,30 Year,0.05
238,206324.46,2147.29,859.68,1287.61,30 Year,0.05
239,205036.85,2147.29,854.32,1292.97,30 Year,0.05
240,203743.88,2147.29,848.93,1298.36,30 Year,0.05
241,202445.52,2147.29,843.52,1303.77,30 Year,0.05
242,201141.75,2147.29,838.09,1309.2,30 Year,0.05
243,199832.55,2147.29,832.63,1314.66,30 Year,0.05
244,198517.89,2147.29,827.15,1320.14,30 Year,0.05
245,197197.75,2147.29,821.65,1325.64,30 Year,0.05
246,195872.11,2147.29,816.13,1331.16,30 Year,0.05
247,194540.95,2147.29,810.58,1336.71,30 Year,0.05
248,193204.24,2147.29,805.01,1342.28,30 Year,0.05
249,191861.96,2147.29,799.42,1347.87,30 Year,0.05
250,190514.09,2147.29,793.8,1353.49,30 Year,0.05
251,189160.6,2147.29,788.16,1359.13,30 Year,0.05
252,187801.47,2147.29,782.5,1364.79,30 Year,0.05
253,186436.68,2147.29,776.81,1370.48,30 Year,0.05
254,185066.2,2147.29,771.1,1376.19,30 Year,0.05
255,183690.01,2147.29,765.37,1381.92,30 Year,0.05
256,182308.09,2147.29,759.61,1387.68,30 Year,0.05
257,180920.41,2147.29,753.83,1393.46,30 Year,0.05
258,179526.95,2147.29,748.02,1399.27,30 Year,0.05
259,178127.68,2147.29,742.19,1405.1,30 Year,0.05
260,176722.58,2147.29,736.34,1410.95,30 Year,0.05
261,175311.63,2147.29,730.46,1416.83,30 Year,0.05
262,173894.8,2147.29,724.56,1422.73,30 Year,0.05
263,172472.07,2147.29,718.63,1428.66,30 Year,0.05
264,171043.41,2147.29,712.68,1434.61,30 Year,0.05
265,169608.8,2147.29,706.7,1440.59,30 Year,0.05
266,168168.21,2147.29,700.7,1446.59,30 Year,0.05
267,166721.62,2147.29,694.67,1452.62,30 Year,0.05
268,165269.0,2147.29,688.62,1458.67,30 Year,0.05
269,163810.33,2147.29,682.54,1464.75,30 Year,0.05
270,162345.58,2147.29,676.43,1470.86,30 Year,0.05
271,160874.72,2147.29,670.31,1476.98,30 Year,0.05
272,159397.74,2147.29,664.15,1483.14,30 Year,0.05
273,157914.6,2147.29,657.97,1489.32,30 Year,0.05
274,156425.28,2147.29,651.77,1495.52,30 Year,0.05
275,154929.76,2147.29,645.54,1501.75,30 Year,0.05
276,153428.01,2147.29,639.28,1508.01,30 Year,0.05
277,151920.0,2147.29,633.0,1514.29,30 Year,0.05
278,150405.71,2147.29,626.69,1520.6,30 Year,0.05
279,148885.11,2147.29,620.35,1526.94,30 Year,0.05
280,147358.17,2147.29,613.99,1533.3,30 Year,0.05
281,145824.87,2147.29,607.6,1539.69,30 Year,0.05
282,144285.18,2147.29,601.18,1546.11,30 Year,0.05
283,142739.07,2147.29,594.74,1552.55,30 Year,0.05
284,141186.52,2147.29,588.27,1559.02,30 Year,0.05
285,139627.5,2147.29,581.78,1565.51,30 Year,0.05
286,138061.99,2147.29,575.25,1572.04,30 Year,0.05
287,136489.95,2147.29,568.7,1578.59,30 Year,0.05
288,134911.36,2147.29,562.13,1585.16,30 Year,0.05
289,133326.2,2147.29,555.52,1591.77,30 Year,0.05
290,131734.43,2147.29,548.89,1598.4,30 Year,0.05
291,130136.03,2147.29,542.23,1605.06,30 Year,0.05
292,128530.97,2147.29,535.54,1611.75,30 Year,0.05
293,126919.22,2147.29,528.83,1618.46,30 Year,0.05
294,125300.76,2147.29,522.08,1625.21,30 Year,0.05
295,123675.55,2147.29,515.31,1631.98,30 Year,0.05
296,122043.57,2147.29,508.51,1638.78,30 Year,0.05
297,120404.79,2147.29,501.68,1645.61,30 Year,0.05
298,118759.18,2147.29,494.82,1652.47,30 Year,0.05
299,117106.71,2147.29,487.94,1659.35,30 Year,0.05
300,115447.36,2147.29,481.03,1666.26,30 Year,0.05
301,113781.1,2147.29,474.08,1673.21,30 Year,0.05
302,112107.89,2147.29,467.11,1680.18,30 Year,0.05
303,110427.71,2147.29,460.11,1687.18,30 Year,0.05
304,108740.53,2147.29,453.08,1694.21,30 Year,0.05
305,107046.32,2147.29,446.02,1701.27,30 Year,0.05
306,105345.05,2147.29,438.93,1708.36,30 Year,0.05
307,103636.69,2147.29,431.81,1715.48,30 Year,0.05
308,101921.21,2147.29,424.67,1722.62,30 Year,0.05
309,100198.59,2147.29,417.49,1729.8,30 Year,0.05
310,98468.79,2147.29,410.28,1737.01,30 Year,0.05
311,96731.78,2147.29,403.04,1744.25,30 Year,0.05
312,94987.53,2147.29,395.78,1751.51,30 Year,0.05
313,93236.02,2147.29,388.48,1758.81,30 Year,0.05
314,91477.21,2147.29,381.15,1766.14,30 Year,0.05
315,89711.07,2147.29,373.79,1773.5,30 Year,0.05
316,87937.57,2147.29,366.4,1780.89,30 Year,0.05
317,86156.68,2147.29,358.98,1788.31,30 Year,0.05
318,84368.37,2147.29,351.53,1795.76,30 Year,0.05
319,82572.61,2147.29,344.05,1803.24,30 Year,0.05
320,80769.37,2147.29,336.53,1810.76,30 Year,0.05
321,78958.61,2147.29,328.99,1818.3,30 Year,0.05
322,77140.31,2147.29,321.41,1825.88,30 Year,0.05
323,75314.43,2147.29,313.81,1833.48,30 Year,0.05
324,73480.95,2147.29,306.17,1841.12,30 Year,0.05
325,71639.83,2147.29,298.49,1848.8,30 Year,0.05
326,69791.03,2147.29,290.79,1856.5,30 Year,0.05
327,67934.53,2147.29,283.06,1864.23,30 Year,0.05
328,66070.3,2147.29,275.29,1872.0,30 Year,0.05
329,64198.3,2147.29,267.49,1879.8,30 Year,0.05
330,62318.5,2147.29,259.66,1887.63,30 Year,0.05
331,60430.87,2147.29,251.79,1895.5,30 Year,0.05
332,58535.37,2147.29,243.89,1903.4,30 Year,0.05
333,56631.97,2147.29,235.96,1911.33,30 Year,0.05
334,54720.64,2147.29,228.0,1919.29,30 Year,0.05
335,52801.35,2147.29,220.0,1927.29,30 Year,0.05
336,50874.06,2147.29,211.97,1935.32,30 Year,0.05
337,48938.74,2147.29,203.91,1943.38,30 Year,0.05
338,46995.36,2147.29,195.81,1951.48,30 Year,0.05
339,45043.88,2147.29,187.68,1959.61,30 Year,0.05
340,43084.27,2147.29,179.51,1967.78,30 Year,0.05
341,41116.49,2147.29,171.31,1975.98,30 Year,0.05
342,39140.51,2147.29,163.08,1984.21,30 Year,0.05
343,37156.3,2147.29,154.81,1992.48,30 Year,0.05
344,35163.82,2147.29,146.51,2000.78,30 Year,0.05
345,33163.04,2147.29,138.17,2009.12,30 Year,0.05
346,31153.92,2147.29,129.8,2017.49,30 Year,0.05
347,29136.43,2147.29,121.4,2025.89,30 Year,0.05
348,27110.54,2147.29,112.96,2034.33,30 Year,0.05
349,25076.21,2147.29,104.48,2042.81,30 Year,0.05
350,23033.4,2147.29,95.97,2051.32,30 Year,0.05
351,20982.08,2147.29,87.42,2059.87,30 Year,0.05
352,18922.21,2147.29,78.84,2068.45,30 Year,0.05
353,16853.76,2147.29,70.22,2077.07,30 Year,0.05
354,14776.69,2147.29,61.56,2085.73,30 Year,0.05
355,12690.96,2147.29,52.87,2094.42,30 Year,0.05
356,10596.54,2147.29,44.15,2103.14,30 Year,0.05
357,8493.4,2147.29,35.38,2111.91,30 Year,0.05
358,6381.49,2147.29,26.58,2120.71,30 Year,0.05
359,4260.78,2147.29,17.75,2129.54,30 Year,0.05
360,2131.24,2147.29,8.88,2138.41,30 Year,0.05
